27 79
WWWWWWWWWWWWWWWWWWWWWWWWWWWWWWWWWWWWWWWWWWWWWWWWWWWWWWWWWWWWWWWWWWWWWWWWWWWWWWW
  W   W     W   W   W       W W   W   W   W     W   W   W       W   W W   W   W
W W W W W W W W W W W WWWWW W W W W W WWW W WWW W WWW W W WWWWW WWW W W W W W W
W W W W W W   W W W   W     W W W W W     W   W W W   W   W   W     W   W   W W
W WWW WWW WWWWW WWWWWWW WWWWW W W W WWWWWWWWW W W W WWW WWWWW WWWWWWWWWWWWWWW W
W   W   W W   W W   W   W       W W W       W W W W W   W   W               W W
WWW WWW W W W WWW W W WWW WWWWWWW W W WWWWW WWW W W W WWW W W WWW WWWWWWWWW W W
W   W   W W W     W W W   W     W W W   W W W   W W W   W W W W   W   W     W W
W WWW WWW W WWWWWWW W W WWW WWW W W WWW W W W WWW W W W WWW WWW WWW W W WWWWW W
W         W W         W W   W W   W     W W W W   W W W         W   W   W     W
WWWWW WWWWW W WWWWW WWW W WWW WWWWWWWWWWW W W W W W W WWWWWWWWWWW W WWWWW WWWWW
W W   W     W W     W   W     W           W W   W   W W       W   W         W W
W W WWW WWWWW W WWWWW WWWWW WWW WWWWWWWWWWW W WWWWWWW W WWW W W WWW WWWWW W W W
W   W   W W   W     W W   W W W   W    SW     W   W   W   W W   W   W     W   W
W WWW WWW W WWWWWWW W W W W W W W WWW W W W WWWWW W W WWW WWWWWWW WWW WWWWW WWW
W W   W   W W   W W     W W W W W     W   W     W W W W W W     W   W     W   W
W W WWWWW W WWW W WWWWWWW W W W WWWWWWWWWWWWWWW W WWW W W W WWW WWW WWWWW WWWWW
W   W     W   W W       W W W W W       W W     W     W   W   W   W   W   W   W
W WWWWW W WWW W W WWWWW W W W W W WWWWW W W WWWWWWWWWWWWWWWWW WWWWWWW WWWWW W W
W     W W W   W   W   W   W     W W   W W   W               W         W     W W
WWWWW WWW W WWWWWWW W W WWWWW WWW W W W W WWW WWWWWWWWWWW WWWWWWWWWWWWW WWWWW W
W W     W W W     W W W   W   W   W W   W   W       W   W W   W         W   W W
W W W W W W W W WWW W WWWWW WWW WWW WWW WWW WWWWWWWWW W W W W W WWWWWWW W W W W
W   W W W W W W   W W       W   W W   W   W   W   W   W W   W W   W   W W W W W
WWWWW W W W W WWW W WWWWWWWWWWW W WWW WWW W W W W W WWW WWWWW WWWWW W W W WWW W
W     W   W   W   W             W     W   W W   W     W             W   W      
WWWWWWWWWWWWWWWWWWWWWWWWWWWWWWWWWWWWWWWWWWWWWWWWWWWWWWWWWWWWWWWWWWWWWWWWWWWWWWW