WWWWWWWWWWWWWWWWWWWWWWWWWWWWWWWWWWWWWWWWWWWWWWWWWW
WT                            W                 KW
W             W          H    W    F         S   W
W    D                        W                  W
W                             W          B       W
W               E      W      W==================W
W                             W                  W
W       LW                    W     D            W
W                     D       W           WWW    W
W                             W           WWW    W
WCCCWWWWWWWWWWWWWWWWWWWWWWWWWWW     WWW   WWW    W
W   WW                  =D          WWW   WWW    W
W   WW    I             =           WWW   WWWD   W
WD  WWWWWWWWWWWWWWWWWWWWWWWWWWWWWWWWWWW   WWW    W
W                  X                      WWW    W
WWWWWWWWWWWWWWWWWWWWWWWWWWWWWWWWWWWWWWWWWWWWW    W
W    D DDDJDDDDDDDD D    D    D   D              W
W  D    DD DD   D    D P   D DD D                W
W1  D         D    D      D D    D               W
WWWWWWWWWWWWWWWWWWWWWWWWWWWWWWWWWWWWWWWWWWWWWWWWWW

X = switch 1 open
Y = switch 2 open
Z = switch 3 open
E = monster
F = hard monster
H = exit
B = pushable block
P = pitfall
C = cracked wall
I = boost
J = bomb
K = strength potions
L = invis pot
= = lava