20 50
WWWWWWWWWWWWWWWWWWWWWWWWWWWWWWWWWWWWWWWWWWWWWWWWWW
W                WWWWW      WWWWWWWWWWWWWWWWWWWWWW
W S              XXXXX  D                    ZZ  W
W           D1   XXXXX      WWWWWWWWWW  D  WWWWD W
W               MWWWWWWWWD  WWWWWWWWWW     WWWW  W
WWWWWWWWYYYWWWWWWWWWWWWWW   W   D   2W D   WWWW  W
WWWWWWWWYYYWWWWWWWWWWWL       P      W    DWWWW IW
WWWWWWWWYYYWWWWWWWWWWWWWWWWWWWWWWWWWWWCCCCCWWWWWWW
W=======  D======WWWWWWWWWW======================W
W=======   ======WWWWWWWWWW======================W
W=======   ======WWWWWWWWWW======================W
W                D   JWWWWWWWWWWWWWWWW  W  WWWWWWW
W     WWD       WW    WWWWW          D  W        W
W     WW        WW    WWWWW   D         WDDDDDD  W
W                     WWWWW       E     W   DDDD W
W          E          WWWWW          D  W        W
W    DWW        WW  D WWWWW    WWWWWWWWWWDDD  DDDW
W D   WW        WW    WWWWW H    DDD     DDDD  DDW
WT     P             3WWWWW          DDD       DDW
WWWWWWWWWWWWWWWWWWWWWWWWWWWWWWWWWWWWWWWWWWWWWWWWWW

