20 65
BBBBBBBBBBBBBBBBBBBBBBBBBBBBBBBBBBBBBBBBBBBBBBBBBBBBBBBBBBBBBBBBBBBBBBBBBBBBBBB
  B   B     B   B   B       B B   B   B   B     B   B   B       B   B B   B   B
B B B B B B B B B B B BBBBB B B B B B BBB B BBB B BBB B B BBBBB BBB B B B B B B
B B B B B B   B B B   B     B B B B B     B   B B B   B   B   B     B   B   B B
B BBB BBB BBBBB BBBBBBB BBBBB B B B BBBBBBBBB B B B BBB BBBBB BBBBBBBBBBBBBBB B
B   B   B B   B B   B   B       B B B       B B B B B   B   B               B B
BBB BBB B B B BBB B B BBB BBBBBBB B B BBBBB BBB B B B BBB B B BBB BBBBBBBBB B B
B   B   B B B     B B B   B     B B B   B B B   B B B   B B B B   B   B     B B
B BBB BBB B BBBBBBB B B BBB BBB B B BBB B B B BBB B B B BBB BBB BBB B B BBBBB B
B         B B         B B   B B   B     B B B B   B B B         B   B   B     B
BBBBB BBBBB B BBBBB BBB B BBB BBBBBBBBBBB B B B B B B BBBBBBBBBBB B BBBBB BBBBB
B B   B     B B     B   B     B           B B   B   B B       B   B         B B
B B BBB BBBBB B BBBBB BBBBB BBB BBBBBBBBBBB B BBBBBBB B BBB B B BBB BBBBB B B B
B   B   B B   B     B B   B B B   B    SB     B   B   B   B B   B   B     B   B
B BBB BBB B BBBBBBB B B B B B B B BBB B B B BBBBB B B BBB BBBBBBB BBB BBBBB BBB
B B   B   B B   B B     B B B B B     B   B     B B B B B B     B   B     B   B
B B BBBBB B BBB B BBBBBBB B B B BBBBBBBBBBBBBBB B BBB B B B BBB BBB BBBBB BBBBB
B   B     B   B B       B B B B B       B B     B     B   B   B   B   B   B   B
B BBBBB B BBB B B BBBBB B B B B B BBBBB B B BBBBBBBBBBBBBBBBB BBBBBBB BBBBB B B
B     B B B   B   B   B   B     B B   B B   B               B         B     B B
BBBBB BBB B BBBBBBB B B BBBBB BBB B B B B BBB BBBBBBBBBBB BBBBBBBBBBBBB BBBBB B
B B     B B B     B B B   B   B   B B   B   B       B   B B   B         B   B B
B B B B B B B B BBB B BBBBB BBB BBB BBB BBB BBBBBBBBB B B B B B BBBBBBB B B B B
B   B B B B B B   B B       B   B B   B   B   B   B   B B   B B   B   B B B B B
BBBBB B B B B BBB B BBBBBBBBBBB B BBB BBB B B B B B BBB BBBBB BBBBB B B B BBB B
B     B   B   B   B             B     B   B B   B     B             B   B      
BBBBBBBBBBBBBBBBBBBBBBBBBBBBBBBBBBBBBBBBBBBBBBBBBBBBBBBBBBBBBBBBBBBBBBBBBBBBBBB