20 50
WWWWWWWWWWWWWWWWWWWWWWWWWWWWWWWWWWWWWWWWWWWWWWWWWW
WT                            W       L  J       W
W             W          H    W    F  I          W
W    D                        W          D       W
W                             W   CCC    B       W
W               E      WM     W==================W
W                             W                  W
W       LW                    W     D            W
W                     D       W           WWW   DW
W                             W           WWW    W
WCCCWWWWWWWWWWWWWWWWWWWWWWWWWWW    DWWW   WWW    W
W   WW                  =D          WWW   WWW    W
W  DWW    1          D  =           WWWD  WWWD   W
W   WWWWWWWWWWWWWWWWWWWWWWWWWWWWWWWWWWW   WWW    W
WD                 X                      WWW    W
WWWWWWWWWWWWWWWWWWWWWWWWWWWWWWWWWWWWWWWWWWWWW    W
WD   D DDDJDDDDDDDD D    D    D   D          D   W
W  D    DD D    D    D P   D  D D  D             W
WI  D        DD    D     DD      D               W
WWWWWWWWWWWWWWWWWWWWWWWWWWWWWWWWWWWWWWWWWWWWWWWWWW
