20 50
WWWWWWWWWWWWWWWWWWWWWWWWWWWWWWWWWWWWWWWWWWWWWWWWWW
W1               WWH          3WWD       D      LW
W   WWWWWWWWWWWD WW            WW  E       WWWWWWW
W   W=       =W  WW      E     WW D             DW
W   W=  ===D =W  WW            WW      D  B      W
W PDW=  =T=  =W  WW============WW  D    D        W
W   W=D =   D=W  WW            WW  WWWWWW   DW===W
W   W=  ======W DWW            WW     2WW  P W   W
WD  WWZZZZZZZWW  WWYYYYYYYYYYYYWW      WW    WI  W
W   WWZZZZZZZWW  WWYYYYYYYYYYYYWWWWWWWWWWD   WWWWW
W    D           WW                          C   W
W          D     WW                 D        C DKW
WWWWWWWW   WWWWWWWWXXXXXXXXXXXXWWWWWWWWWWWWWWWWWWW
WWWWWWWW   WWWWWWWWXXXXXXXXXXXXWWWWWWWWWWWWWWWWWWW
W          D            P                        W
W                D                 D             W
W    D     E               D             D  S    W
W                    WZZZZZW                     W
WJD               D  W  E  W                   DMW
WWWWWWWWWWWWWWWWWWWWWWWWWWWWWWWWWWWWWWWWWWWWWWWWWW
