WWWWWWWWWWWWWWWWWWWWWWWWWWWWWWWWWWWWWWWWWWWWWWWWWW
W        S        W             W        H       W
W                 W             W                W
W                 W             W        F       W
W        D        W             W                W
W                 W             W                W
W                 W             W        D       W
W  D           D  W             W================W
W                 W             W================W
W                 W             W================W
WWWWWWW     WWWWWWWWWWWWWWWWWWWWWWWWWWYYYYYWWWWWWW
W     W         D              DW                W
W     W               WW        W                W
W     W    DWWWWWW    WW   WWW  W       W        W
W     W     WD        WW  DW W          W        W
WWWWWWWYYYWWWWWWWWWWWWWW   W W          W        W
W       D W            W   WWW  WWWWWXXXWWWW     W
W  T      W    1    D           W          W    DW
W         W                     W   I      W    2W
WWWWWWWWWWWWWWWWWWWWWWWWWWWWWWWWWWWWWWWWWWWWWWWWWW

X = switch 1 open
Y = switch 2 open
Z = switch 3 open
F = hard monster
I = boost item
H = exit
= = lava