20 50
WWWWWWWWWWWWWWWWWWWWWWWWWWWWWWWWWWWWWWWWWWWWWWWWWW
W                 WWWWWWWWWWWWWWW        H       W
W                 WWWWWWWWWWWWWWW                W
W                 WWWWWWWWWWWWWWW        N       W
W        D        WWWWWWWWWWWWWWW                W
W                 WWWWWWWWWWWWWWW                W
W                 WWWWWWWWWWWWWWW        D       W
W  D           D  WWWWWWWWWWWWWWWLLLLLLLLLLLLLLLLW
W                 WWWWWWWWWWWWWWWLLLLLLLLLLLLLLLLW
W                 WWWWWWWWWWWWWWWLLLLLLLLLLLLLLLLW
WWWWWWW     WWWWWWWWWWWWWWWWWWWWWWWWWWYYYYYWWWWWWW
WWWWWWW         D              DW                W
WWWWWWW               WW        W                W
WWWWWWW    DWWWWWW    WW   WWW  W       W        W
WWWWWWW     WD        WW  DWWW          W        W
WWWWWWWYYYWWWWWWWWWWWWWW   WWW          W        W
W       D W            W   WWW  WWWWWXXXWWWW     W
W  T      W    1    D           W          W    DW
W         W                     W   I      W    2W
WWWWWWWWWWWWWWWWWWWWWWWWWWWWWWWWWWWWWWWWWWWWWWWWWW