20 50
WWWWWWWWWWWWWWWWWWWWWWWWWWWWWWWWWWWWWWWWWWWWWWWWWW
WT                            W                 KW
W             W          H    W    F         S   W
W    D                        W                  W
W                             W          B       W
W               E      W      W==================W
W                             W                  W
W       LW                    W     D            W
W                     D       W           WWW    W
W                             W           WWW    W
WCCCWWWWWWWWWWWWWWWWWWWWWWWWWWW     WWW   WWW    W
W   WW                  =D          WWW   WWW    W
W   WW    1             =           WWW   WWWD   W
WD  WWWWWWWWWWWWWWWWWWWWWWWWWWWWWWWWWWW   WWW    W
W                  X                      WWW    W
WWWWWWWWWWWWWWWWWWWWWWWWWWWWWWWWWWWWWWWWWWWWW    W
WD   D DDDJDDDDDDDD D    D    D   D              W
W  D    DD DD   D    D P   D DD D                W
WI  D        DD    D     DD D    D               W
WWWWWWWWWWWWWWWWWWWWWWWWWWWWWWWWWWWWWWWWWWWWWWWWWW
